10
10
3
2
200
0001000000
1101000200
0000000000
0011001111
0210000000
1110000000
0010000000
0200100000
0010000000
0100100000
2 0 0 1
6 5 0 -1