14
6
3
2
200
01000102010012
01000100010010
01000100010010
00000000000000
01000100010010
01000100010210
3 0 0 1
0 10 1 0